[38;5;223m[48;5;58mAdjective (Causing an unpleasant feeling of fear or unease)[0m
- eerie                               - scary
- spooky                              - frightening
- terrifying                          - awful
- chilling                            - eery
- macabre                             - nightmarish
- sinister                            - disturbing
- harrowing                           - horrific
- horrifying                          - menacing
- ominous                             - petrifying
- shocking                            - spookish
- threatening                         - dreadful
- freaky                              - ghostly
- haunting                            - uncanny
- weird                               - direful
- hairy                               - horrible
- scaring                             - unearthly
- disgusting                          - eldritch
- ghoulish                            - gruesome
- nasty                               - strange
- unpleasant                          - shuddersome
- hair-raising                        - spine-chilling
- blood-curdling                      - ghastly
- frightful                           - fearful
- fearsome                            - alarming
- terrible                            - horrendous
- forbidding                          - dire
- intimidating                        - appalling
- formidable                          - redoubtable
- grim                                - supernatural
- bloodcurdling                       - dread
- hideous                             - grisly
- monstrous                           - mysterious
- horrid                              - unnerving
- spine-tingling                      - unreal
- daunting                            - disquieting
- unnatural                           - spectral
- bizarre                             - abnormal
- grotesque                           - other-worldly
- rum                                 - ghostlike
- lurid                               - unspeakable
- gloomy                              - odd
- queer                               - baleful
- freakish                            - grewsome
- wraithlike                          - ethereal
- foreboding                          - haunted
- otherworldly                        - startling
- awesome                             - bodeful
- dangerous                           - grievous
- distressing                         - awe-inspiring
- curious                             - mystifying
- insubstantial                       - preternatural
- mystic                              - magical
- terrific                            - nightmare
- hostile                             - traumatic
- atrocious                           - cadaverous
- spiritual                           - unwelcoming
- morbid                              - unfriendly
- corpselike                          - funereal
- dark                                - uninviting
- shadowy                             - deathlike
- worrying                            - brooding
- indistinct                          - disconcerting
- inhospitable                        - dismaying
- mean-looking                        - odious
- perilous                            - glowering
- ferocious                           - unsettling
- bone-chilling                       - Kafkaesque
- foul                                - gross
- evil                                - melodramatic
- off-putting                         - hellish
- nightmarey                          - phantasmagorical
- feared                              - possessed
- imposing                            - perturbing
- pulse-pounding                      - dreaded
- jinxed                              - cursed
- overpowering                        - upsetting
- phantom                             - unusual
- shivery                             - shuddery
- hellacious                          - abominable
- godawful                            - sepulchral
- phobic                              - gnarly
- nerve-racking                       - severe
- all-powerful                        - phantasmal
- phantasmic                          - from hell
- causing fear                        - unpromising
- inauspicious                        - evil-looking
- gothic                              - Gothic
- far-out                             - uneasy
- inscrutable                         - offensive
- dismal                              - illusory
- life-threatening                    - bleak
- repulsive                           - ugly
- depressing                          - phantomlike
- demonic                             - flakey
- occult                              - uncouth
- eerily                              - flaky
- secret                              - magic
- oddball                             - whacko
- numinous                            - supernal
- suggestive of evil                  - crawly
- superstitious                       - peculiar
- paranormal                          - fantastic
- eidolic                             - wraithy
- apparitional                        - holy
- wan                                 - divine
- pale                                - vampiric
- demoniac                            - demonish
- demonlike                           - devilish
- skeletal                            - deathly
- demonly                             - out of the ordinary
- corpse-like                         - bizarro
- inexplainable                       - tragic
- calamitous                          - unheard-of
- very strange                        - loathsome
- revolting                           - sickening
- abhorrent                           - bad
- vile                                - execrable
- repellent                           - repugnant
- grave                               - wretched
- sombre                              - somber
- heinous                             - miserable
- cruel                               - nauseating
- detestable                          - rotten
- sick                                - beastly
- diabolical                          - gory
- troublesome                         - harsh
- objectionable                       - unfortunate
- disagreeable                        - agitating
- vicious                             - obscene
- solemn                              - sad
- doleful                             - grody
- woeful                              - outrageous
- troubling                           - hateful
- fiendish                            - stressful
- bitter                              - torturous
- wicked                              - difficult
- morose                              - mean
- deplorable                          - lamentable
- unwelcome                           - scandalous
- irksome                             - worrisome
- discomforting                       - diabolic
- agonizing                           - distressful
- black                               - despicable
- satanic                             - sober
- uncomfortable                       - distasteful
- inhuman                             - unpalatable
- hard                                - nefarious
- savage                              - serious
- troublous                           - lousy
- disgustful                          - poor
- loathly                             - excruciating
- egregious                           - fraught
- yucky                               - humourless
- humorless                           - adverse
- disheartening                       - sedate
- cheerless                           - desolate
- agonising                           - galling
- sick-making                         - infernal
- twisted                             - disgraceful
- intolerable                         - terrorizing
- shameful                            - disastrous
- brutal                              - contemptible
- tough                               - unsightly
- demoniacal                          - misshapen
- heavy                               - unforgivable
- oppressive                          - sullen
- regrettable                         - annoying
- austere                             - insufferable
- terrorising                         - dreary
- melancholy                          - unbearable
- unappealing                         - icky
- tormenting                          - displeasing
- cold                                - unlovely
- unpleasing                          - accursed
- barbarous                           - irritating
- bloody                              - Hadean
- unfavorable                         - unfavourable
- heartbreaking                       - dour
- noisome                             - painful
- saddening                           - mortifying
- tragical                            - ruthless
- merciless                           - damnable
- vexatious                           - Mephistophelian
- extreme                             - pitiless
- drear                               - hopeless
- desperate                           - heartrending
- unhappy                             - obnoxious
- shady                               - afflictive
- sorrowful                           - abysmal
- glum                                - repellant
- nauseous                            - hurtful
- God-awful                           - very bad
- cacodemonic                         - Stygian
- injurious                           - discouraging
- undesirable                         - gray
- mournful                            - grey
- parlous                             - treacherous
- unpropitious                        - gut-churning
- critical                            - sadistic
- perverted                           - ungodly
- unkind                              - callous
- lou                                 - astounding
- oppressed                           - impoverished
- stark                               - sanguine
- unpardonable                        - abject
- tremendous                          - sickly
- infamous                            - catastrophic
- violent                             - cataclysmic
- poverty-stricken                    - great
- ruinous                             - inexcusable
- devastating                         - fugly
- misproportioned                     - reptilian
- villainous                          - blood-stained
- inconvenient                        - punk
- excessive                           - crummy
- discomposing                        - unsavory
- huckery                             - unsatisfactory
- stinking                            - unacceptable
- unendurable                         - iniquitous
- melancholic                         - dispirited
- depressive                          - lewd
- wrong                               - stupefying
- uncool                              - yukky
- grotty                              - sour
- pathetic                            - awkward
- afflicting                          - affecting
- brutish                             - bestial
- barbaric                            - tenebrous
- heartstopping                       - unsavoury
- concerning                          - anguished
- uncongenial                         - stunning
- rancid                              - astonishing
- bewildering                         - overwhelming
- fulsome                             - amazing
- noxious                             - staggering
- like the back end of a bus          - as ugly as sin
- murky                               - drab
- mirthless                           - lugubrious
- dingy                               - depraved
- flagitious                          - base
- surprising                          - glaring
- nail-biting                         - heart-rending
- heart-breaking                      - gut-wrenching
- extremely bad                       - nerve-wracking
- unhealthy                           - immoral
- aberrant                            - rough
- straitened                          - ill-fated
- hard-pressed                        - joyless
- discommodious                       - tortured
- harmful                             - troubled
- full of hardship                    - doubtful
- strained                            - exacting
- ill-omened                          - ill-boding
- negative                            - pressing
- precarious                          - comfortless
- exigent                             - messy
- jeopardous                          - apocalyptic
- rocky                               - death-obsessed
- rugged                              - trying
- cataclysmal                         - forlorn
- destructive                         - blue
- sorry                               - onerous
- malformed                           - burdensome
- taxing                              - unhandsome
- unbeautiful                         - distorted
- ill-favored                         - homely
- teratoid                            - unpretty
- mutant                              - miscreated
- unattractive                        - shapeless
- deformed                            - uncomely
- stiff                               - weighty
- searing                             - ill-favoured
- murderous                           - hardhanded
- backbreaking                        - hefty
- rough going                         - scurvy
- flagrant                            - beyond the pale
- dispiriting

[38;5;223m[48;5;58mAdjective (Characterized by, or tending to cause, agitation or anxiety)[0m
- unnerving                           - unsettling
- distressing                         - disturbing
- tense                               - uneasy
- agitating                           - disquieting
- distressful                         - hairy
- worrisome                           - anxious
- fraught                             - nervous
- restless                            - alarming
- nerve-racking                       - nerve-wracking
- nail-biting                         - worrying
- upsetting                           - troubling
- disconcerting                       - difficult
- dismaying                           - perturbing
- trying                              - frightening
- annoying                            - irritating
- harassing                           - perplexing
- troublesome                         - discomforting
- stressful                           - bothersome
- irksome                             - vexing
- aggravating                         - disruptive
- unpleasant                          - discouraging
- startling                           - embarrassing
- provoking                           - concerning
- wearisome                           - painful
- ominous                             - discommoding
- severe                              - foreboding
- gloomy                              - onerous
- sinister                            - depressing
- pessimistic                         - discomposing
- exciting                            - nagging
- nasty                               - tiresome
- inconvenient                        - burdensome
- disagreeable                        - troublous
- antsy                               - harrowing
- laborious                           - hard
- toilsome                            - threatening
- consequential                       - intrusive
- impeding                            - uncertain
- prophetic                           - jittery
- scary                               - apprehensive
- charged                             - uncomfortable
- panicky                             - uptight
- intimidating                        - anxious-making
- insecure                            - fretful
- gut-wrenching                       - off-putting
- confronting                         - tormenting
- strained                            - bothering
- tricky                              - knife-edge
- troubled                            - edgy
- discomfiting                        - cliffhanging
- dramatic                            - volatile
- devastating                         - emotionally charged
- jarring                             - explosive
- white-knuckle                       - awkward
- nervy                               - dithery
- distracting                         - stressed
- barro                               - demoralising
- demoralizing                        - worried
- overwrought                         - twitchy
- agitated                            - taut
- rigid                               - unrelaxed
- excited                             - unquiet
- spooky                              - queasy
- concerned                           - queazy
- on edge                             - daunting
- terrifying                          - taxing
- menacing                            - exasperating
- maddening                           - traumatic
- agonizing                           - vexatious
- agonising                           - heartbreaking
- grievous                            - deplorable
- dreadful                            - shocking
- tragical                            - afflicting
- heart-rending                       - woeful
- sad                                 - tragic
- unfortunate                         - lamentable
- grave                               - regrettable
- heartrending                        - hurtful
- saddening                           - heart-breaking
- problematic                         - niggling
- thorny                              - excruciating
- sticky                              - prickly
- harrying                            - pitiful
- appalling                           - poignant
- afflictive                          - torturous
- dire                                - unlucky
- miserable                           - grim
- wretched                            - dismal
- bitter                              - chilling
- bleak                               - dangerous
- poor                                - sombre
- somber                              - unhappy
- doleful                             - awful
- affecting                           - sorrowful
- bad                                 - crushing
- terrible                            - adrenaline-charged
- exhilarating                        - horrifying
- abysmal                             - ugly
- roller-coaster                      - fearful
- flustering                          - haunting
- shattering                          - extremely upsetting
- overwhelming                        - scarring
- savage                              - eerie
- cheerless                           - disheartening
- hopeless                            - thrilling
- dreary                              - disappointing
- emotionally exhausting              - emotionally depleting
- sorry                               - morose
- joyless                             - racking
- torturing                           - desolate
- oppressive                          - glum
- comfortless                         - pitiable
- melancholy                          - drab
- dispiriting                         - rueful
- raging                              - wrenching
- depressive                          - melancholic
- funereal                            - disconsolate
- dejecting                           - dispirited
- lachrymose                          - cold
- mirthless                           - heart-wrenching
- dolorous                            - dolesome
- horrible                            - horrendous
- objectionable                       - horrific
- horrid                              - monstrous
- humourless                          - unsatisfactory
- execrable                           - pathetic
- icky                                - stinking
- sober                               - rotten
- unendurable                         - distasteful
- anguished                           - unappealing
- crummy                              - offensive
- unpalatable                         - abominable
- unsavoury                           - repellant
- uncool                              - odious
- repellent                           - yukky
- cruel                               - forbidding
- grotty                              - yucky
- hideous                             - revolting
- loathsome                           - hellacious
- lurid                               - macabre
- disgusting                          - nauseating
- unacceptable                        - ghastly
- sedate                              - atrocious
- displeasing                         - foul
- godawful                            - lousy
- beastly                             - uncongenial
- unlovely                            - unwelcome
- detestable                          - nightmarish
- unpleasing                          - unsavory
- mortifying                          - harsh
- abhorrent                           - vile
- humorless                           - unbearable
- sickening                           - obnoxious
- uninviting                          - galling
- hostile                             - extremely bad
- grisly                              - grody
- repulsive                           - gruesome
- gross                               - repugnant
- undesirable                         - solemn
- diabolical                          - sour
- frightful                           - nauseous
- mean                                - tearing
- soaring                             - hazardous
- emotionally draining                - terribly bad
- very bad                            - unstable
- perilous                            - dicey
- unsafe                              - volcanic
- iffy                                - inflammable
- serious                             - delicate
- sensitive                           - combustible
- highly charged                      - touch-and-go
- critical

[38;5;223m[48;5;58mAdjective (Very odd, strange, or eccentric)[0m
- freaky                              - strange
- odd                                 - bizarre
- unusual                             - weird
- peculiar                            - queer
- curious                             - eccentric
- freakish                            - abnormal
- unconventional                      - outlandish
- extraordinary                       - offbeat
- funny                               - irregular
- atypical                            - anomalous
- wacky                               - aberrant
- oddball                             - rum
- crazy                               - unexpected
- screwy                              - deviant
- wild                                - bizarro
- unnatural                           - wacko
- untypical                           - eerie
- surprising                          - spooky
- surreal                             - grotesque
- perverse                            - unco
- fishy                               - amazing
- chance                              - far-out
- off-centre                          - out of the ordinary
- way out                             - out of the way
- erratic                             - suspicious
- dubious                             - questionable
- remarkable                          - quirky
- quaint                              - uncanny
- unfamiliar                          - puzzling
- mysterious                          - kooky
- mystifying                          - different
- perplexing                          - whacky
- baffling                            - funky
- weirdo                              - kookie
- kinky                               - freak
- queerish                            - unaccountable
- incongruous                         - off-the-wall
- off-kilter                          - way-out
- spaced-out                          - cranky
- outr√©                               - out-of-the-way
- uncommon                            - singular
- uncustomary                         - rare
- off the wall                        - preternatural
- outre                               - unorthodox
- unique                              - dodgy
- uncharacteristic                    - unaccustomed
- shady                               - droll
- exceptional                         - zany
- idiosyncratic                       - foreign
- monstrous                           - whimsical
- fantastic                           - fanciful
- wayward                             - humorous
- unpredictable                       - arbitrary
- inexplicable                        - capricious
- malformed                           - vagarious
- fitful                              - teratoid
- changeable                          - out-there
- prodigious                          - exceeding
- aberrated                           - unwonted
- especial                            - unparalleled
- phenomenal                          - extraordinaire
- dilly                               - anomalistic
- ridiculous                          - scarce
- inconceivable                       - ludicrous
- nonstandard                         - out of line
- off-base                            - inscrutable
- off-color                           - like nothing on earth
- unheard of                          - doubtful
- doubtable                           - disputable
- equivocal                           - suspect
- disquieting                         - debatable
- shaky                               - dubitable
- problematical                       - problematic
- flakey                              - unhinged
- touched                             - mad
- irrational                          - unbalanced
- demented                            - flaky
- left-field                          - dark
- shonky                              - mysterious-looking
- not quite right                     - funny-looking
- strange-looking                     - not kosher
- novel                               - special
- incredible                          - exotic
- alien                               - infrequent
- unordinary                          - astonishing
- unthinkable                         - unimaginable
- unprecedented                       - unforeseen
- unanticipated                       - noteworthy
- astounding                          - isolated
- new                                 - preposterous
- conspicuous                         - original
- something else                      - unheard-of
- startling                           - befuddling
- unrepresentative                    - unknown
- out there                           - untried
- unexplored                          - out of the common
- sporadic                            - outstanding
- stupefying                          - notable
- daggy                               - bewildering
- shocking                            - unbelievable
- memorable                           - wonderful
- divergent                           - intriguing
- incomprehensible                    - sensational
- seldom                              - stunning
- unlikely                            - dumfounding
- atypic                              - distinct
- awe-inspiring                       - obscure
- flustering                          - confounding
- jarring                             - jolting
- unannounced                         - eye-popping
- little known                        - out of place
- off-key                             - staggering
- striking                            - comical
- deviating                           - flabbergasting
- blindsiding                         - twisted
- perverted                           - confusing
- weird and wonderful                 - occasional
- awesome                             - distinguished
- prominent                           - significant
- eminent                             - refreshing
- absurd                              - fantastical
- nonsensical                         - warped
- foolish                             - cockamamie
- insane                              - unreal
- dumbfounding                        - devious
- fresh                               - deviate
- distorted                           - aberrational
- non-typical                         - far-fetched
- alternative                         - few and far between
- dissimilar                          - heteroclite
- variant                             - out of this world
- dramatic                            - thin on the ground
- rogue                               - overwhelming
- remote                              - uninvestigated
- recondite                           - newfangled
- jaw-dropping                        - eye-opening
- mind-blowing                        - mind-boggling
- paradoxical                         - offhand
- illogical                           - inconsistent
- avant-garde                         - loner
- cool                                - arcane
- nondescript                         - extreme
- egregious                           - few
- awkward                             - disconsonant
- inapropos                           - irrelevant
- disparate                           - incongruent
- incoherent                          - unfathomable
- breaking new ground                 - interesting
- incomparable                        - unexampled
- altered                             - imported
- ready                               - ironic
- devastating                         - bent
- random                              - unintelligible
- momentous                           - miraculous
- seldom seen                         - improbable
- unforgettable                       - eye-catching
- arresting                           - digressive
- nonconformist                       - transgressing
- non-standard                        - awful
- unsettling                          - unnerving
- spectacular                         - stupendous
- unrealistic                         - not prepared
- off-beat                            - impressive
- sick                                - beyond your ken
- serious                             - extravagant
- implausible                         - grandiose
- tremendous                          - wondrous
- unhealthy                           - off the rails
- exciting                            - amazeballs
- heterodox                           - corrupt
- disconcerting                       - sicko
- pervy                               - heavy
- flash                               - gnarly
- forby                               - hare-brained
- sparse                              - one of a kind
- bugged out                          - unnormal
- heteromorphic                       - out of character
- make-believe                        - wandering
- varying                             - heretical
- off the beaten track                - hard to swallow
- beyond belief                       - scattered
- intermittent                        - never to be forgotten
- limited                             - portentous
- off beaten path                     - aperiodic
- unpredicted                         - episodic
- casual                              - episodical
- discontinuous                       - muddling
- discomfiting                        - nonplussing
- shattering                          - nonplusing
- dismaying                           - upsetting
- sudden                              - not normal
- rarefied                            - periodical
- scant                               - periodic
- scanty                              - spasmodic
- semioccasional                      - better than expected
- out of the blue                     - from left field
- distinctive                         - unfrequent
- unrecognized                        - brand new
- previously unencountered            - uncharted
- unrecognised                        - outside one's experience
- fluky                               - fortuitous
- unforeseeable                       - surprise

[38;5;223m[48;5;58mAdjective (Very difficult or impossible to forget)[0m
- haunting                            - eerie
- eery                                - spooky
- uncanny                             - unearthly
- weird                               - evocative
- poignant                            - unforgettable
- affecting                           - emotive
- expressive                          - indelible
- touching                            - atmospheric
- memorable                           - moving
- nostalgic                           - plaintive
- powerful                            - spookish
- stirring                            - wistful
- lasting                             - lingering
- melancholy                          - nagging
- obsessive                           - ongoing
- persistent                          - recurrent
- recurring                           - repeated
- soul-stirring                       - never to be forgotten
- not to be forgotten                 - skittish

[38;5;223m[48;5;58mAdjective (Arousing revulsion or disgust, especially physically)[0m
- disgusting                          - revolting
- distasteful                         - foul
- repellent                           - sickening
- gross                               - nasty
- nauseating                          - obnoxious
- odious                              - horrid
- nauseous                            - repulsive
- horrible                            - displeasing
- horrendous                          - obscene
- repugnant                           - abhorrent
- abominable                          - appalling
- awful                               - grotty
- horrific                            - loathsome
- offensive                           - repellant
- shocking                            - stinking
- vile                                - yucky
- bad                                 - dreadful
- grievous                            - gruesome
- hideous                             - icky
- noisome                             - off-putting
- rotten                              - scandalous
- sordid                              - unsavory
- unsavoury                           - unwelcome
- dire                                - disagreeable
- frightful                           - ghastly
- grisly                              - horrifying
- sick                                - ugly
- undesirable                         - beastly
- disgustful                          - dismaying
- evil                                - filthy
- fulsome                             - galling
- grody                               - lousy
- putrid                              - rancid
- sleazy                              - tasteless
- terrible                            - unpleasant
- unpleasing                          - vomitous
- bogging                             - cloying
- festy                               - God-awful
- loathly                             - macabre
- noxious                             - rebarbative
- scurvy                              - scuzzy
- skanky                              - squicky
- surfeiting                          - unappetizing
- yucko                               - yecchy
- cringe-making                       - gut-churning
- sick-making                         - stomach-churning
- stomach-turning                     - vomit-inducing
- detestable                          - hateful
- reprehensible                       - execrable
- deplorable                          - despicable
- contemptible                        - objectionable
- unpalatable                         - intolerable
- unspeakable                         - monstrous
- heinous                             - dislikeable
- atrocious                           - beyond the pale
- insufferable                        - unacceptable
- base                                - invidious
- damnable                            - pesky
- slimy                               - uncool
- pestiferous                         - poisonous
- crummy                              - hateable
- ornery                              - hated
- reviled                             - mean
- incompatible                        - inconsistent
- adverse                             - hostile
- contradictory                       - opposed
- uninviting                          - uncongenial
- unlovely                            - harsh
- dirty                               - sour
- bitter                              - wicked
- averse                              - antagonistic
- antipathetic                        - inimical
- opposite                            - against
- extraneous                          - alien
- unconformable                       - foreign
- unfriendly                          - different
- revulsive                           - extrinsic
- unfitted                            - counter
- forbidding                          - cruddy
- brackish                            - messy
- in opposition                       - mucky
- very disgusting                     - raunchy
- vulgar                              - funky
- outrageous                          - wretched
- distressing                         - diabolical
- grim                                - shameful
- upsetting                           - disgraceful
- hellacious                          - annoying
- unattractive                        - fearful
- yukky                               - malodorous
- rank                                - irritating
- fetid                               - abysmal
- godawful                            - exceptionable
- foetid                              - miserable
- mephitic                            - alarming
- frightening                         - disreputable
- terrifying                          - stinky
- nightmarish                         - sorry
- dishonourable                       - unappealing
- ignominious                         - dishonorable
- paltry                              - pitiful
- terrific                            - smelly
- nightmare                           - unbearable
- lurid                               - irksome
- immoral                             - egregious
- hellish                             - ignoble
- niffy                               - from hell
- on the nose                         - discreditable
- lamentable                          - sad
- olid                                - grubby
- unsightly                           - grewsome
- unsatisfactory                      - poor
- woeful                              - foul-smelling
- evil-smelling                       - vexatious
- sinful                              - low
- villainous                          - iniquitous
- grotesque                           - unprincipled
- dislikable                          - pongy
- whiffy                              - degenerate
- morbid                              - censurable
- troublesome                         - miasmal
- scummy                              - harrowing
- scabby                              - criminal
- unholy                              - pitiable
- opprobrious                         - black
- bothersome                          - calamitous
- pathetic                            - dismal
- rude                                - insupportable
- acrid                               - pestilential
- inhuman                             - squalid
- corrupt                             - unscrupulous
- ungodly                             - inexcusable
- unwholesome                         - cheap
- smutty                              - disturbing
- snide                               - indescribable
- painful                             - ratty
- infamous                            - accursed
- unutterable                         - unclean
- sneaking                            - abject
- lame                                - depressing
- unforgivable                        - regrettable
- sinister                            - vicious
- vexing                              - very unpleasant
- low-down                            - dishonest
- infernal                            - wrong
- unseemly                            - bestial
- depraved                            - grimy
- currish                             - confounded
- impure                              - cursed
- dark                                - perturbing
- unwanted                            - worrying
- grungy                              - poison
- gory                                - dingy
- difficult                           - bloody
- very bad                            - inappropriate
- aggravating                         - scurrilous
- exasperating                        - unnerving
- daunting                            - unpardonable
- shady                               - deformed
- loathed                             - uneatable
- spine-chilling                      - low-minded
- emetic                              - savage
- nefarious                           - disfigured
- brutal                              - unrighteous
- unprepossessing                     - unsettling
- out of order                        - unlikable
- inedible                            - repelling
- profane                             - murderous
- crooked                             - pits
- troubling                           - dissolute
- violent                             - weird
- polluted                            - severe
- debauched                           - flagitious
- perverted                           - fierce
- frustrating                         - hairy
- discouraging                        - cussed
- hurtful                             - chronic
- tremendous                          - crude
- unsuitable                          - wanton
- inadmissible                        - harmful
- smudged                             - bedraggled
- befouled                            - sullied
- bemired                             - dusty
- uncleanly                           - draggled
- muddy                               - illegal
- stained                             - besmirched
- unfair                              - blackened
- unsportsmanlike                     - begrimed
- soiled                              - scabrous
- unethical                           - uncomfortable
- debased                             - improper
- unworthy                            - concerning
- disconcerting                       - unlawful
- injurious                           - seedy
- bum                                 - degrading
- hopeless                            - ill-favoured
- ill-favored                         - indefensible
- reprobate                           - agonizing
- dreary                              - cheerless
- gut-wrenching                       - tragic
- unfortunate                         - bleak
- defective                           - disappointing
- sombre                              - somber
- gloomy                              - dodgy
- unhappy                             - as ugly as sin
- agonising                           - rankling
- maddening                           - beyond contempt
- unpretty                            - disheartening
- unhandsome                          - detested
- out of line                         - unbeautiful
- execrated                           - plain
- despised                            - abominated
- abrasive                            - riling
- insipid                             - flavourless
- uncomely                            - traumatic
- plain-featured                      - shabby
- worrisome                           - misshapen
- infuriating                         - plain-looking
- reeking                             - carking
- nettling                            - peeving
- chafing                             - nettlesome
- fiendish                            - provoking
- trying                              - inconvenient
- resentful                           - blasted
- jarring                             - flavorless
- cruel                               - perverse
- treacherous                         - plaguy
- pestilent                           - troublous
- seamy                               - incommodious
- bloodthirsty                        - off-color
- unconscionable                      - disquieting
- flagrant                            - lewd
- coarse                              - flat
- substandard                         - savorless
- useless                             - inferior
- tormenting                          - catty
- barbarous                           - afflictive
- overwhelming                        - inadequate
- salacious                           - licentious
- unchaste                            - immodest
- suggestive                          - lascivious
- bawdy                               - rubbish
- afflicting                          - awkward
- weak                                - pernicious
- laughable                           - pesty
- plaguey                             - unearthly
- worthless                           - huckery
- bland                               - embarrassing
- biting                              - cutting
- scatological                        - scatologic
- inexpedient                         - condemnable
- unhealthy                           - tainted
- pants                               - covetous
- startling                           - bent
- agitating                           - excruciating
- shoddy                              - dubious
- blue                                - loose
- lustful                             - pornographic
- prurient                            - shameless
- diabolic                            - venal
- solemn                              - discourteous
- tricky                              - degraded
- intimidating                        - godforsaken
- fearsome                            - short on looks
- bad-looking                         - mercenary
- impertinent                         - insolent
- warped                              - eerie
- scary                               - punk
- heartbreaking                       - abandoned
- raw                                 - ribald
- porno                               - barnyard
- grave                               - disastrous
- dastardly                           - distressful
- gnarly                              - impossible
- inexpressible                       - formidable
- tenth-rate                          - off
- bewildering                         - unjustifiable
- mournful                            - melancholic
- depressive                          - morose
- glum                                - melancholy
- slighting                           - insulting
- malevolent                          - sullen
- maligning                           - vilifying
- detractive                          - detracting
- no-good                             - X-rated
- inclement                           - sickly
- yechy                               - dull
- uninteresting                       - chunderous
- offending                           - hatable
- duff                                - poxy
- unheard-of                          - indecorous
- diseased                            - morally wrong
- wrongful                            - deleterious
- mischievous                         - rocky
- woozy                               - irreligious
- abhorred                            - sanguinary
- unfit                               - sacrilegious
- intense                             - baneful
- blasphemous                         - shonky
- impious                             - inglorious
- preposterous                        - senseless
- untrustworthy                       - godless
- shuddersome                         - mighty
- yicky                               - pill
- heel                                - deadly
- insalutary                          - dangerous
- ridiculous                          - foolish
- homely                              - acute
- maggot                              - scaring
- pain                                - drag
- terribly bad                        - untempting
- dissipated                          - culpable
- crashing                            - destructive
- sucky                               - reeky
- blameworthy                         - fugly
- notorious                           - suspicious
- rascally                            - suspect
- astounding                          - animal
- beast                               - musty
- stenchy                             - strong
- high                                - fusty
- disrespectful                       - sanguine
- reproachable                        - serious
- amoral                              - unbelievable
- inconceivable                       - abusive
- tawdry                              - inhospitable
- joyless                             - unwelcoming
- comfortless                         - frowzy
- frowsy                              - miasmic
- frowsty                             - eye-watering
- petrifying                          - guilty
- blamable                            - discomforting
- pigpen                              - ripe
- unimaginable                        - deceitful
- spine-tingling                      - bloodletting
- stressful                           - torturous
- untold                              - undescribable
- ineffable                           - malignant
- erring                              - heavy
- caitiff                             - scungy
- blood-and-guts                      - blood-and-thunder
- blameable                           - vitiated
- malicious                           - servile
- decadent                            - derogatory
- not okay                            - discomposing
- humourless                          - humorless
- sober                               - doleful
- mortifying                          - blood-stained
- unpopular                           - dreaded
- disliked                            - unalluring
- errant                              - funny
- iffy                                - drack
- freaking                            - darned
- cotton-picking                      - doggoned
- durn                                - doggone
- goddamned                           - deuced
- curst                               - danged
- durned                              - dang
- darn                                - delinquent
- green-eyed                          - envious
- jealous                             - a load of pants
- stupefying                          - fraught
- sedate                              - unendurable
- faithless                           - perfidious
- beyond words                        - preternatural
- undefinable                         - louche
- sleazoid                            - avaricious
- reprovable                          - provocative
- impudent                            - affronting
- heartstopping                       - unenticing
- tragical                            - saddening
- affecting                           - blimming
- unwished-for                        - malfeasant
- staggering                          - stunning
- astonishing                         - amazing
- direful                             - indescribably bad
- indescribably wicked                - beyond description
- indescribably evil                  - desperate
- backbiting                          - untrue
- crying                              - indecent
- traducing                           - gossiping
- boorish                             - uncouth
- bribable                            - peccable
- calculated                          - beneath contempt
- below contempt                      - maleficent
- ugly-looking                        - surprising
- redoubtable                         - grating
- acid                                - sharp
- tart                                - shifty
- rough                               - anguished
- heartrending                        - sorrowful
- indigestible                        - stale
- unconsumable                        - unsought
- detrimental                         - scorned
- shunned                             - outcast
- disadvantageous                     - uninvited
- rejected                            - wounding
- no good                             - jaundiced
- highly improper                     - glaring
- no oil painting                     - not much to look at
- as plain as a pikestaff             - low-life
- dirty rotten                        - self-seeking
- tiresome                            - thorny
- irking                              - harassing
- red hot                             - too horrible for words
- ghostly                             - dispirited
- desolate                            - mephitical
- irritable                           - unkind
- dispiriting                         - poignant
- testing                             - perplexing
- unfavorable                         - unfavourable
- unpropitious                        - unlucky
- troubled                            - austere
- unamusing                           - inauspicious
- foreboding                          - ominous
- parlous                             - distressed
- contaminated                        - spoiled
- unpleasant-tasting                  - turned
- hair-raising                        - uncivil
- impolite                            - unmannerly
- for the birds                       - unwished for
- tenebrous                           - sepulchral
- funereal                            - cold
- niggling                            - tedious
- challenging                         - harrying
- puzzling                            - wearisome
- enraging                            - antagonizing
- problematic                         - knotty
- taxing                              - nerve-racking
- nail-biting                         - heart-rending
- heart-breaking                      - extremely bad
- nerve-wracking                      - amiss
- remiss                              - demeritorious
- to be avoided                       - out of place
- strictly for the birds              - shadowy
- gray                                - grey
- pitiless                            - murky
- drab                                - mirthless
- lugubrious                          - drear
- spoilt                              - burdensome
- nagging                             - spooky
- chilling                            - spookish
- at fault                            - tough as old boots
- unfit for human consumption         - not fit to eat
- death-obsessed                      - festering
- teasing                             - wearing
- demanding                           - reptilian
- unsatisfying                        - antagonising
- enough to try the patience of a saint - enough to drive you up the wall
- hard-favoured                       - hard-featured
- slanderous                          - libellous
- envying                             - spiteful
- calumnious                          - libelous
- defamatory                          - detractory
- subpar                              - dissatisfactory
- suboptimal                          - deficient
- wanting                             - impermissible
- mediocre                            - imperfect
- amateurish                          - insufficient
- unimpressive                        - faulty
- unreasonable                        - questionable
- meagre                              - meager
- trashy                              - wack
- cheapo                              - irremediable
- garbage                             - crumby
- tatty                               - out
- rubbishy                            - devilish
- inacceptable                        - bush
- reject                              - barbaric
- bush-league                         - below average
- poor quality                        - low-grade
- not cricket                         - under par
- won't do                            - low-quality
- below standard                      - poor-quality
- below par                           - half-baked
- of low quality                      - not up to par
- not on                              - second rate
- of poor quality                     - third-rate
- not up to scratch                   - over the fence
- less-than-stellar                   - from hunger
- not up to snuff                     - second-class
- not quite the done thing            - second-rate
- two-bit                             - not up to standard
- brutish                             - ruthless
- merciless                           - sadistic
- ferocious                           - heartless
- knavish                             - brute
- callous                             - underhanded
- remorseless                         - miscreant
- inhumane                            - butcherly
- profligate                          - demoralised
- demoralized                         - black-hearted
- cold-blooded

[38;5;223m[48;5;58mAdjective (Giving the impression that something harmful or evil is happening or will happen)[0m
- sinister                            - menacing
- threatening                         - ominous
- baleful                             - disquieting
- forbidding                          - inauspicious
- portentous                          - dire
- disturbing                          - minatory
- alarming                            - black
- dark                                - direful
- eerie                               - evil
- frightening                         - unpropitious
- bodeful                             - doomy
- eldritch                            - evil-looking
- foreboding                          - ill
- ill-boding                          - ill-omened
- malign                              - malignant
- scary                               - spooky
- injurious                           - malevolent
- minacious                           - minatorial
- sinistrous                          - adverse
- apocalyptic                         - baneful
- blackhearted                        - deleterious
- disastrous                          - dishonest
- doomful                             - harmful
- hurtful                             - lowering
- malefic                             - mischievous
- nasty                               - obnoxious
- pernicious                          - perverse
- poisonous                           - suggestive of evil
- unfavorable                         - unfavourable
- unfortunate                         - unlucky
- woeful                              - dangerous
- bad                                 - gloomy
- detrimental                         - ruinous
- damaging                            - calamitous
- fateful                             - unpromising
- destructive                         - deadly
- noxious                             - prejudicial
- unhealthy                           - disadvantageous
- grim                                - unwholesome
- nocuous                             - malicious
- ill-fated                           - hostile
- intimidatory                        - catastrophic
- cataclysmic                         - fatal
- wicked                              - undesirable
- maleficent                          - inimical
- crippling                           - warning
- lethal                              - toxic
- impending                           - perilous
- hazardous                           - devastating
- negative                            - virulent
- venomous                            - untoward
- subversive                          - prejudicious
- cancerous                           - corrupting
- counterproductive                   - unsafe
- ugly                                - wounding
- corroding                           - incendiary
- intimidating                        - glowering
- undermining                         - brooding
- inopportune                         - doomed
- overhanging                         - loury
- parlous                             - critical
- painful                             - dicey
- nocent                              - corrosive
- premonitory                         - annihilative
- eradicative                         - extirpative
- suicidal                            - wintry
- dismal                              - unfriendly
- infelicitous                        - pessimistic
- augural                             - suggestive
- haunting                            - prophetic
- thunderous                          - worrying
- dreadful                            - wintery
- heavy                               - comminatory
- bullying                            - terrorizing
- louring                             - portending
- near                                - aggressive
- close                               - impendent
- upcoming                            - lowery
- scowling                            - forthcoming
- looming                             - terrorising
- ill-starred                         - inexpedient
- risky                               - at hand
- environmentally unfriendly          - corruptive
- clouded                             - precursive
- prescient                           - malificent
- inhospitable                        - presaging
- fearful                             - glum
- morose                              - cautionary
- admonitory                          - moody
- troubled                            - fearsome
- terrifying                          - mean-looking
- troubling                           - doom and gloom
- imminent                            - approaching
- untimely                            - unhappy
- tragic                              - vindictive
- bleak                               - significant
- foreshadowing                       - momentous
- insidious                           - hard
- imperilling                         - imperiling
- afflictive                          - evil-intentioned
- antagonistic                        - terrible
- predictive                          - prognosticatory
- important                           - crucial
- bitter                              - hate-filled
- acrimonious                         - unchancy
- vitriolic                           - cataclysmal
- ravaging                            - inspiring
- exciting                            - intriguing
- remarkable                          - fated
- exhilarating                        - phenomenal
- destined                            - thrilling
- extraordinary                       - spiteful
- awful                               - shocking
- appalling                           - grievous
- annihilatory                        - horrible
- devastative                         - unsuccessful
- damning                             - abortive
- hapless                             - luckless
- precarious                          - murderous
- lethiferous                         - insalubrious
- pestilential                        - internecine
- pestiferous                         - harassing
- wreckful                            - sinful
- wrackful                            - slaughterous
- noisome                             - lamentable
- wretched                            - deplorable
- miserable                           - pitiful
- poor                                - atrocious
- regrettable                         - distressing
- sad                                 - pathetic
- horrendous                          - rotten
- lousy                               - frightful
- hopeless                            - sorry
- abysmal                             - abominable
- grave                               - heartbreaking
- crummy                              - execrable
- jinxed                              - inferior
- unsatisfactory                      - egregious
- disgraceful                         - star-crossed
- harrowing                           - pitiable
- unacceptable                        - diabolical
- inadequate                          - paltry
- ghastly                             - shameful
- disappointing                       - intolerable
- substandard                         - sorrowful
- mediocre                            - cursed
- serious                             - godawful
- laughable                           - cruddy
- offensive                           - desperate
- snakebitten                         - second-rate
- snakebit                            - catastrophal
- unspeakable                         - horrid
- chronic                             - lame
- hard luck                           - gruesome
- rubbish                             - gross
- heartrending                        - out of luck
- distressful                         - afflicted
- hideous                             - punk
- mean                                - odious
- third-rate                          - heinous
- objectionable                       - horrifying
- mournful                            - abject
- disagreeable                        - cheap
- reprehensible                       - vile
- contemptible                        - inept
- inappropriate                       - trashy
- rubbishy                            - shoddy
- mortal                              - unsuitable
- pants                               - awkward
- severe                              - shattering
- insufferable                        - sucky
- low-grade                           - God-awful
- unwelcome                           - low-quality
- grotty                              - outrageous
- abhorrent                           - monstrous
- beastly                             - upsetting
- doleful                             - forlorn
- tragical                            - crushing
- blighted                            - ignominious
- dirty                               - piteous
- tough                               - repulsive
- very bad                            - extreme
- deficient                           - duff
- shabby                              - unbearable
- wanting                             - agonizing
- stricken                            - meagre
- ruined                              - meager
- garbage                             - sickening
- forsaken                            - destitute
- unprosperous                        - difficult
- damnable                            - worthless
- poxy                                - agonising
- indefensible                        - god-awful
- stinking                            - dissatisfactory
- in a bad way                        - unbecoming
- below par                           - cut-rate
- under par                           - less-than-stellar
- poor-quality                        - second-class
- two-bit                             - crumby
- bum                                 - horrific
- wack                                - a load of pants
- bush-league                         - desolate
- earth-shattering                    - melancholy
- grisly                              - inexcusable
- nightmarish                         - dread
- distasteful                         - displeasing
- anguished                           - ill-chosen
- cruel                               - harsh
- scandalous                          - unpleasant
- revolting                           - despicable
- redoubtable                         - iniquitous
- fierce                              - spine-chilling
- formidable                          - hair-raising
- base                                - grubby
- scummy                              - scurvy
- ratty                               - scabby
- terrific                            - unsightly
- sordid                              - misfortunate
- insupportable                       - loathsome
- useless                             - subpar
- suboptimal                          - repugnant
- ridiculous                          - detestable
- sub-par                             - inconvenient
- unseemly                            - heart-rending
- wrong                               - junky
- improper                            - bush
- ropy                                - faulty
- exacting                            - scurrilous
- off                                 - stinky
- irremediable                        - poor quality
- cheesy                              - derisory
- not up to par                       - schlocky
- not up to scratch                   - low-rent
- el cheapo                           - not up to snuff
- excessive                           - bargain-basement
- pained                              - shattered
- broken                              - burdened
- unadvantageous                      - violent
- convulsionary                       - climactic
- climacteric                         - foredoomed
- monumental                          - disadvantaged
- bungling                            - fire-and-brimstone
- apocalyptical                       - bedevilled
- condemned                           - moving
- galling                             - discouraging
- stirring                            - dejected
- vexatious                           - despondent
- destroyed                           - hateful
- sleazy                              - unpopular
- undesired                           - nefarious
- disheartening                       - revealing
- oracular                            - dreaded
- glaring                             - dilapidated
- bedeviled                           - hellfire
- deathly                             - flagrant
- accident-prone                      - sneaking
- vicious                             - lurid
- macabre                             - unforgivable
- absurd                              - ludicrous
- foolish-looking                     - silly
- rueful                              - affecting
- flagitious                          - unnerving
- petrifying                          - blighting
- messy                               - senseless
- inglorious                          - preposterous
- rough                               - yucky
- common                              - schlock
- incriminating                       - unpalatable
- unpardonable                        - unconscionable
- foolish                             - traumatic
- saddening                           - depressing
- cheerless                           - tough luck
- behind eight ball                   - bad break
- down on luck                        - run down
- flimsy                              - shlocky
- gimcrack                            - cheapjack
- godforsaken                         - seedy
- shlock                              - weak
- coarse                              - down at heel
- trumpery                            - blameworthy
- ill-advised                         - overwhelming
- disgusting                          - ignoble
- immoral                             - discreditable
- disreputable                        - grieving
- plaintive                           - tear-jerking
- damnatory                           - condemnatory
- blah                                - unjustifiable
- dishonourable                       - dishonorable
- disconsolate                        - agonized
- too bad                             - feeble
- raunchy                             - tinhorn
- downer                              - icky
- diddly                              - valueless
- bummer                              - the pits
- grody                               - bad news
- fallacious                          - grungy
- not good                            - erroneous
- not the best                        - tortured
- racked                              - agonised
- criminal                            - opprobrious
- pits                                - blue
- crying                              - pressing
- urgent                              - unsought
- unwanted                            - beyond contempt
- implicating                         - derogatory
- condemning                          - drastic
- trying                              - unfit
- testing                             - troublesome
- bothersome                          - challenging
- prohibitive                         - ill-timed
- uncomplimentary                     - unseasonable
- irretrievable                       - impermissible
- exceptionable                       - inadmissible
- repellant                           - repellent
- imperfect                           - amateurish
- insufficient                        - unimpressive
- exigent                             - dubious
- unreasonable                        - dodgy
- low                                 - questionable
- not much cop                        - implicatory
- strong                              - accusatorial
- conclusive                          - implicative
- dooming                             - condemnable
- crude                               - defective
- tatty                               - out
- cheapo                              - hurting
- oppressing                          - gut-wrenching
- inacceptable                        - unappealing
- uninviting                          - reject
- not on                              - below average
- second rate                         - not cricket
- of poor quality                     - beyond the pale
- won't do                            - over the fence
- tenth-rate                          - below standard
- from hunger                         - not quite the done thing
- half-baked                          - not up to standard
- of low quality                      - out of order
- rancid                              - hellish
- rebarbative                         - disgustful
- hellacious                          - loathly
- sombre                              - somber
- intense                             - straitened
- unrelenting                         - excruciating
- tortuous                            - spartan
- rigorous                            - scabrous
- stern                               - sober
- unendurable                         - biting
- uncomfortable                       - austere
- comfortless                         - inexorable
- stringent                           - solemn
- discomforting                       - considerable
- life-threatening                    - acute
- brutal                              - consequential
- major                               - arduous
- strenuous                           - toilsome
- taxing                              - sobering
- big                                 - punishing
- grinding                            - weighty
- intensive                           - peracute

[38;5;223m[48;5;58mAdjective (Relating to or characteristic of reptiles)[0m
- reptilian                           - horrible
- nasty                               - unpleasant
- devious                             - disagreeable
- sly                                 - unattractive
- underhand                           - ingratiating
- off-putting                         - oily
- unappealing                         - unctuous
- distasteful                         - horrid
- sneaky                              - crafty
- fulsome                             - oleaginous
- slimy                               - smarmy
- untrustworthy

[38;5;223m[48;5;58mAdjective (Not giving hope of future success or good results)[0m
- unpromising                         - discouraging
- gloomy                              - inauspicious
- ominous                             - unfavorable
- unfavourable                        - adverse
- disadvantageous                     - disheartening
- uninviting                          - unpropitious
- baleful                             - black
- bleak                               - doomed
- doubtful                            - foreboding
- hopeless                            - jinxed
- portentous                          - cursed
- dubious                             - ill-fated
- ill-omened                          - infelicitous
- off-putting                         - unhopeful
- unlucky                             - threatening
- unfortunate                         - dire
- menacing                            - untimely
- ill                                 - inopportune
- sinister                            - direful
- untoward                            - bad
- hostile                             - forbidding
- dismal                              - bodeful
- fateful                             - minatory
- doomy                               - depressing
- dark                                - ill-boding
- regrettable                         - calamitous
- detrimental                         - destructive
- unhappy                             - inconvenient
- unseasonable                        - damaging
- unfriendly                          - grim
- unsuited                            - dangerous
- inexpedient                         - harmful
- negative                            - troublesome
- improper                            - minacious
- ugly                                - evil
- unseemly                            - objectionable
- baneful                             - unsuitable
- impending                           - unfit
- malapropos                          - discommodious
- inhospitable                        - perilous
- wrong                               - opposed
- ill-starred                         - apocalyptic
- dreary                              - terrible
- inadvisable                         - dreadful
- inapt                               - inappropriate
- pessimistic                         - ill-advised
- dispiriting                         - ill-suited
- prejudicial                         - daunting
- disturbing                          - inconducive
- counter                             - premonitory
- wintry                              - ruinous
- warning                             - disastrous
- harsh                               - inimical
- sinistrous                          - fearful
- unadvantageous                      - brooding
- lowering                            - augural
- suggestive                          - haunting
- prophetic                           - alarming
- disparaging                         - worrying
- wintery                             - glowering
- poor                                - frightful
- wretched                            - very bad
- unpleasant                          - nasty
- desperate                           - unlikely
- downbeat                            - unencouraging
- unhealthy                           - deleterious
- unwholesome                         - disagreeable
- bringing bad luck                   - unoptimistic
- unsatisfactory                      - tardy
- late                                - contrary
- antagonistic                        - low
- hapless                             - star-crossed
- disappointing                       - significant
- foreshadowing                       - momentous
- lamentable                          - cataclysmic
- heavy                               - thunderous
- predictive                          - prognosticatory
- important                           - crucial
- bullying                            - sombre
- somber                              - dampening
- intimidatory                        - comminatory
- terrorizing                         - foredoomed
- blighted                            - luckless
- catastrophic                        - injurious
- deplorable                          - unwelcome
- tragic                              - distressing
- grievous                            - clouded
- precursive                          - prescient
- malificent                          - doomful
- presaging                           - malign
- malefic                             - portending
- near                                - aggressive
- close                               - impendent
- upcoming                            - lowery
- loury                               - overhanging
- terrorising                         - scowling
- forthcoming                         - cataclysmal
- fatal                               - tough
- frightening                         - snakebitten
- hard luck                           - snakebit
- bedevilled                          - inspiring
- exciting                            - intriguing
- remarkable                          - fated
- exhilarating                        - phenomenal
- destined                            - thrilling
- extraordinary                       - demoralizing
- tragical                            - miserable
- woeful                              - heartrending
- heartbreaking                       - devastating
- distressful                         - damning
- at hand                             - skeptical
- dejecting                           - repressing
- depressive                          - dissuading
- oppressive                          - dismaying
- upsetting                           - hindering
- deterring                           - awful
- deadly                              - hard
- catastrophal                        - bedeviled
- fearsome                            - shattering
- crippling                           - sceptical
- dim                                 - suspicious
- not encouraging                     - not hopeful
- demoralising                        - severe
- scary                               - chilling
- unwelcoming                         - disquieting
- horrible                            - horrendous
- dread                               - spine-chilling
- redoubtable                         - formidable
- hair-raising                        - shocking
- ghastly                             - horrifying
- terrifying                          - intimidating
- evil-looking                        - mean-looking
- spooky                              - offensive
- odious                              - life-threatening
- repulsive                           - ferocious
- unchancy                            - suggestive of evil
- hurtful                             - pernicious
- awkward                             - ill-timed
- nocuous                             - undesirable
- noxious                             - nocent
- prejudicious                        - wicked
- maleficent                          - poisonous
- malignant                           - mischievous
- mistimed                            - counterproductive
- difficult                           - cancerous
- unsympathetic                       - bothersome
- badly timed                         - corrupting
- unbecoming                          - lethal
- toxic                               - virulent
- wounding                            - ill-chosen
- malicious                           - undermining
- venomous                            - hazardous
- painful                             - problematic
- corrosive                           - corroding
- discommoding                        - annoying
- unconducive                         - irritating
- afflicted                           - out of luck
- unmanageable                        - subversive
- environmentally unfriendly          - antipathetic
- parlous                             - critical
- anti                                - premature
- dicey                               - unbefitting
- incommodious                        - disruptive
- early                               - incommoding
- incendiary                          - annihilative
- eradicative                         - extirpative
- suicidal                            - pestiferous
- ill-disposed                        - inept
- perverse                            - unsuccessful
- forsaken                            - destitute
- unprosperous                        - undue
- uncomplimentary                     - refractory
- malevolent                          - abusive
- in a bad way                        - willful
- intractable                         - unruly
- ungovernable                        - wilful
- wayward                             - recalcitrant
- headstrong                          - incontrollable
- uncontrollable                      - aggravating
- froward                             - vexing
- vexatious                           - stubborn
- unyielding                          - against
- disobliging                         - averse
- pestilential                        - unsafe
- risky                               - opposing
- down on                             - unprofitable
- noisome                             - precocious
- ruining                             - destroying
- unhelpful                           - at odds
- intrusive                           - ruined
- pained                              - stricken
- shattered                           - troubled
- broken                              - burdened
- unsynchronized                      - cruel
- sorrowful                           - pestilent
- tiresome                            - precarious
- hasty                               - foul
- vile                                - unhandy
- obstructive                         - nullifying
- invalidating                        - annulling
- counteractive                       - neutralizing
- indecorous                          - injudicious
- tactless                            - insidious
- nefarious                           - miasmatic
- miasmic                             - mortal
- spiteful                            - misjudged
- ill-judged                          - unwieldy
- murderous                           - aching
- hurting                             - afflictive
- iniquitous                          - cantankerous
- reprobate                           - not conducive
- oppugnant                           - inimicable
- inimic                              - disaffected
- repugnant                           - killing
- worrisome                           - cumbersome
- lethiferous                         - wrackful
- insalubrious                        - internecine
- harassing                           - wreckful
- sinful                              - slaughterous
- unacceptable                        - too bad
- eerie                               - impeding
- dyslogistic                         - depreciative
- slighting                           - downside
- derogatory                          - detracting
- pejorative                          - debit-side
- depreciatory                        - eldritch
- trying                              - testing
- challenging                         - prohibitive
- disobedient                         - balky
- misplaced                           - incongruous
- unfitting                           - ill-fitted
- shameful                            - disgraceful
- minatorial                          - unanticipated
- unexpected                          - corruptive
- dishonest                           - obnoxious
- blackhearted                        - contumacious
- rebellious                          - restive
- defiant                             - rebel
- recusant                            - insubordinate
- incompliant                         - obstreperous
- on the debit side                   - neutralising
- unforeseen                          - unpredictable
- unusual                             - surprising
- unpredicted                         - ill-considered
- accident-prone                      - pitiful
- insubmissive                        - obstinate
- cross                               - peevish
- petulant                            - tough luck
- behind eight ball                   - bad break
- down on luck                        - uncooperative
- misfortunate                        - undisciplined
- unpliable                           - fractious
- indocile                            - wild
- cold                                - cool
- loath                               - unwilling
- reluctant                           - disinclined
- advance                             - too early
- early on                            - anachronistic
- out-of-date                         - too late
- soon                                - a bit previous
- before time                         - overearly
- too soon                            - early bird
- bright and early                    - previous
- oversoon                            - abortive
- allergic                            - indisposed
- unenthusiastic                      - uneager
- fromward                            - afraid
- hesitant                            - disliking
- agin                                - hostile to
- antagonistic to                     - resistant to
- antipathetic to                     - ill-disposed to
- opposed to                          - having no use for
- unfavourably disposed to

[38;5;223m[48;5;58mAdjective (Undesirable or unfavorable)[0m
- unpopular                           - disliked
- shunned                             - rejected
- unloved                             - unwanted
- friendless                          - detested
- spurned                             - uncherished
- hated                               - despised
- unbefriended                        - avoided
- loathed                             - ignored
- ostracised                          - ostracized
- scorned                             - unwelcome
- disesteemed                         - disfavored
- unaccepted                          - execrated
- abhorred                            - unvalued
- unliked                             - unattractive
- undesirable                         - drip
- dumpy                               - gross
- loser                               - lousy
- nerdy                               - obnoxious
- out                                 - weird
- wimpy                               - in bad odor
- in bad odour                        - out of favour
- out of favor                        - cold-shouldered
- out in the cold                     - sent to Coventry
- unsought after                      - not sought out
- uncared for                         - not in the swim
- forsaken                            - outcast
- in the doghouse                     - in disgrace
- abandoned                           - in the dogbox
- in someone's black books            - in someone's bad books
- uncared-for                         - despicable
- isolated                            - lonesome
- forlorn                             - companionless
- abhorrent                           - lonely
- estranged                           - desolate
- all alone                           - without friends
- with no one to turn to              - without a friend in the world
- blackballed                         - useless
- offensive                           - superfluous
- withdrawn                           - destitute
- sad                                 - unappreciated
- despondent                          - neglected
- unnecessary                         - jilted
- unbeloved                           - loveless
- unhappy                             - lorn
- unsocial                            - abominated
- not loved                           - unneeded
- without companions                  - by yourself
- feeling friendless                  - condemned
- cursed                              - anathematized
- nonessential                        - annoying
- discarded                           - surplus to requirements
- de trop                             - alone
- solitary                            - deserted
- unattached                          - disgraced
- alienated                           - lone
- single                              - by oneself
- cut off                             - in trouble
- adrift                              - marooned
- without ties                        - with no ties
- all by one's self

[38;5;223m[48;5;58mAdjective (Which attempts to bring oneself into the favour of another, often with flattery or insincerity)[0m
- ingratiating                        - sycophantic
- crawling                            - fawning
- flattering                          - obsequious
- servile                             - creeping
- toadying                            - unctuous
- bootlicking                         - honey-tongued
- humble                              - insincere
- silver-tongued                      - slick
- smooth                              - smooth-talking
- smooth-tongued                      - submissive
- cajoling                            - cloying
- disarming                           - endearing
- greasy                              - insinuating
- nauseating                          - oily
- saccharine                          - sickening
- slippery                            - smarmy
- wheedling                           - winning
- winsome                             - brown-nosing
- charming                            - deferential
- insinuative                         - serving
- silken                              - slimy
- soft                                - sucky
- timeserving                         - Uriah Heepish
- oleaginous                          - soapy
- grovelling                          - groveling
- fulsome                             - subservient
- cringing                            - suave
- gushing                             - buttery
- smug                                - self-abasing
- apple-polishing                     - forelock-tugging
- arse-licking                        - ass-kissing
- abject                              - slavish
- reptilian                           - sycophantish
- toadyish                            - craven
- excessively deferential             - suckholing
- conniving                           - glib
- adulatory                           - urbane
- gushy                               - hagiographical
- hagiographic                        - effusive
- plausible                           - hypocritical
- saponaceous                         - phoney
- pinguid                             - creamy
- phony                               - smooth-spoken
- sugary                              - honeyed
- encomiastic                         - mealy-mouthed
- truckling                           - appreciative
- sweet-talking                       - kowtowing
- extravagant                         - enthusiastic
- rhapsodic                           - lavish
- acclamatory                         - eulogistic
- complimentary                       - encomiastical
- OTT                                 - ingratiatory
- over the top                        - reverential
- excessive                           - overdone
- base                                - sniveling
- compliant                           - brownnosing
- parasitical                         - parasitic
- spineless                           - laudatory
- sweet                               - menial
- admiring                            - snivelling
- obeisant                            - low
- mean                                - glowing
- arse-kissing                        - insinuatory
- suggestive                          - rave
- applauding                          - unrestrained
- ebullient                           - expansive
- unreserved                          - lyrical
- exuberant                           - highly favourable
- bowing and scraping                 - mushy
- sentimental                         - emotional
- despicable                          - soft-soaping
- respectful                          - over-effusive
- silky                               - over-enthusiastic
- hyped up                            - laid on with a trowel
- sleek                               - overly flattering
- supple                              - bland
- coaxing                             - self-effacing
- bowing                              - flannelling
- blarneying                          - docile
- gratifying                          - eloquent
- inordinate                          - blubbery
- hammy                               - voluble
- sophisticated                       - all over someone
- immoderate                          - praising
- polished                            - assured
- profuse                             - extensive
- liberal                             - ample
- generous                            - fast-talking
- blandishing                         - worshipful
- over-appreciative                   - commending
- lionizing                           - obedient
- unresisting                         - beggarly
- passive                             - ignoble
- rapturous                           - sugarcoated
- lionising                           - subordinate
- gross                               - persuasive
- pleasing                            - eating crow
- magniloquent                        - bombastic
- grandiloquent                       - canting
- coarse                              - overgenerous
- sanctimonious                       - compliable
- media-savvy                         - self-assured
- eating humble pie                   - sweet-sounding
- mellifluous                         - refined
- approving                           - commendatory
- congratulatory                      - panegyrical
- maudlin                             - eulogizing
- good                                - favorable
- positive                            - friendly
- approbatory                         - laudative
- overemotional                       - mawkish
- nostalgic                           - plauditory
- polite                              - civil
- honoring                            - fair-spoken
- celebrating                         - eulogising
- well-wishing                        - with high praise
- courtly                             - with highest recommendation
- gracious                            - honouring
- praiseful                           - kind
- favourable                          - approbative
- highly favorable                    - overacted
- bathetic                            - icky
- corny                               - affectionate
- moonstruck                          - jejune
- inane                               - demonstrative
- languishing                         - overenthusiastic
- impressionable                      - affected
- dreamy                              - idealistic
- insipid                             - loving
- dewy-eyed                           - lovey-dovey

[38;5;223m[48;5;58mAdjective (Sly, cautious, and secretive)[0m
- furtive                             - secret
- covert                              - clandestine
- surreptitious                       - sneaky
- private                             - undercover
- stealthy                            - underhand
- sneaking                            - underground
- backstairs                          - stealth
- underhanded                         - privy
- sly                                 - sneak
- hidden                              - secretive
- conspiratorial                      - black
- shifty                              - indirect
- skulking                            - slinking
- wily                                - slippery
- cloaked                             - cunning
- crafty                              - artful
- shady                               - masked
- foxy                                - evasive
- guileful                            - tricky
- scheming                            - cautious
- disguised                           - calculating
- circumspect                         - elusive
- insidious                           - hush-hush
- behind-the-scenes                   - hugger-mugger
- hole-and-corner                     - under wraps
- under-the-table                     - sub-rosa
- behind someone's back               - under the table
- cloak and dagger                    - hole and corner
- cloak-and-dagger                    - concealed
- closet                              - veiled
- shrouded                            - incognito
- on the QT                           - back-alley
- confidential                        - devious
- undisclosed                         - discreet
- backstair                           - enigmatic
- cryptic                             - dark
- designing                           - subtle
- hole-in-the-corner                  - camouflaged
- unscrupulous                        - silent
- classified                          - unknown
- mysterious                          - unrevealed
- dissembled                          - backdoor
- under-the-counter                   - quiet
- unofficial                          - cagey
- restricted                          - deep
- top-secret                          - covered
- deceitful                           - clever
- dishonest                           - duplicitous
- conniving                           - reticent
- treacherous                         - close
- crooked                             - fraudulent
- deceptive                           - shonky
- catlike                             - fly
- inside                              - slick
- in ambush                           - slim
- mystic                              - enigmatical
- surprise                            - shrewd
- carny                               - astute
- sharp                               - traitorous
- feline                              - top secret
- buried                              - obscured
- dissembling                         - intriguing
- bluffing                            - strictly confidential
- smooth                              - unpublished
- canny                               - dishonourable
- dishonorable                        - ingenious
- illusory                            - plotting
- captious                            - smart
- delusive                            - untold
- double-dealing                      - incog
- on the sly                          - unseen
- clouded                             - on the quiet
- sub rosa                            - hushed
- not for publication                 - off the record
- not to be disclosed                 - not for circulation
- not to be made public               - in secret
- dissimulated                        - intelligence
- unbowed                             - subversive
- dirty                               - unfair
- shorthanded                         - unethical
- murky                               - snide
- quick                               - sideways
- spy                                 - unauthorized
- catty                               - noiseless
- unauthorised                        - huggermugger
- cowardly                            - yellow
- creep                               - underneath
- uncommunicated                      - Machiavellian
- low-down                            - disingenuous
- unsuspected                         - beguiling
- cute                                - dodgy
- untrustworthy                       - manipulative
- cagy                                - QT
- ulterior                            - illegal
- illicit                             - illegitimate
- undeclared                          - unprofessed
- hidden away                         - anonymous
- skillful                            - skilful
- nifty                               - mean
- mum                                 - with a lid on
- mom                                 - unreported
- inscrutable                         - unidentified
- nameless                            - unnamed
- in holes and corners                - ambiguous
- occult                              - strange
- obscure                             - unenlightened
- unintelligible                      - out-of-the-way
- mystical                            - on the side
- unspecified                         - faceless
- shadowy                             - uncanny
- impenetrable                        - arcane
- nebulous                            - opaque
- abstruse                            - unsung
- protected                           - sphinxlike
- magical                             - closed
- privileged                          - intimate
- backstage                           - esoteric
- nonpublic                           - mystery
- non-committal                       - pretend
- false                               - unrecognizable
- assumed                             - offstage
- inconspicuous                       - censored
- sphinx-like                         - roguish
- non-public                          - artificial
- sham                                - fake
- forged                              - mock
- imitation                           - behind the scenes
- under one's hat                     - t√™te-√†-t√™te
- in camera                           - not open
- close to one's chest                - one-on-one
- not in the public domain            - pseudo
- feigned                             - counterfeit
- phoney                              - impish
- arch                                - mischievous
- uncommunicative                     - reserved
- masquerading                        - changed
- unrecognisable                      - phony
- in disguise                         - withdrawn
- taciturn                            - unforthcoming
- sailing under false colours         - under cover
- introverted                         - closemouthed
- guarded                             - introvert
- clamlike                            - zipped
- coy                                 - tight-lipped
- close-mouthed                       - self-contained
- in chambers                         - non-communicative
- buttoned up                         - tight-mouthed
- clammed up                          - in the background
- in privacy                          - in private
- playing your cards close to your chest - in the dark

[38;5;223m[48;5;58mAdjective (Showing or feeling insecurity or uncertainty)[0m
- jumpy                               - nervous
- anxious                             - tense
- restless                            - edgy
- jittery                             - shaky
- uneasy                              - worried
- apprehensive                        - fidgety
- nervy                               - fretful
- on edge                             - unrelaxed
- antsy                               - ill at ease
- overwrought                         - twitchy
- uptight                             - quivering
- shaking                             - strained
- trembling                           - wired
- het up                              - keyed up
- on tenterhooks                      - strung out
- worked up                           - wrought up
- aflutter                            - agitated
- atwitter                            - dithery
- goosey                              - hinky
- hyper                               - insecure
- on pins and needles                 - perturbed
- queasy                              - queazy
- spooky                              - squirrelly
- stressy                             - troubled
- unquiet                             - upset
- white-knuckled                      - windy
- in a state of agitation             - in a state of nerves
- overstrung                          - timorous
- toey                                - a bundle of nerves
- excited                             - frightened
- frisky                              - hung up
- in a state                          - in a stew
- scared                              - sensitive
- spooked                             - stressed out
- strung up                           - unrestful
- all of a dither                     - all of a doodah
- all of a lather                     - in a tizz
- in a tizzy                          - like a cat on hot bricks
- like a cat on a hot tin roof        - unsettled
- disturbed                           - stressed
- fearful                             - bothered
- restive                             - concerned
- distressed                          - disquieted
- highly strung                       - neurotic
- high-strung                         - discomposed
- afraid                              - hysterical
- excitable                           - distraught
- skittish                            - wound up
- in a flap                           - unnerved
- flustered                           - uncomfortable
- ruffled                             - alarmed
- in a sweat                          - in a twitter
- shaken                              - disconcerted
- panicky                             - in suspense
- having kittens                      - discombobulated
- in a twit                           - adrenalized
- hesitant                            - flurried
- worried sick                        - unstable
- impatient                           - frantic
- tormented                           - in a dither
- unglued                             - distracted
- brittle                             - irritable
- vexed                               - bundle of nerves
- overanxious                         - dismayed
- bricking oneself                    - beside oneself
- febrile                             - harassed
- annoyed                             - shy
- trepidatious                        - shook up
- uncertain                           - terrified
- angsty                              - choked
- rattled                             - nervous wreck
- timid                               - in a cold sweat
- bugged                              - irked
- hot and bothered                    - anguished
- taut                                - wriggly
- squirmy                             - quaking
- unsure                              - hectic
- flighty                             - frenzied
- fluttery                            - self-conscious
- irresolute                          - afflicted
- touchy                              - overactive
- heated                              - moved
- fazed                               - embarrassed
- wrought-up                          - irascible
- unhappy                             - wiggly
- saddened                            - discomfited
- unsteady                            - under stress
- clutched                            - discountenanced
- fidgeting                           - up the wall
- suspicious                          - tortured
- plagued                             - perplexed
- waiting for the axe to fall         - bummed out
- cut up                              - all torn up
- like a fish out of water            - waiting with bated breath
- having butterflies in the stomach   - awkward
- desperate                           - fevered
- overexcited                         - nail-biting
- feeling anxious                     - irrational
- bashful                             - weak
- skittery                            - careful
- spasmodic                           - shocked
- out of place                        - in a panic
- emotional                           - inhibited
- fretting                            - under a strain
- fraught                             - shivery
- stirred                             - worked-up
- inflamed                            - hurt
- fractious                           - aroused
- wretched                            - miffed
- itchy                               - unruly
- fitful                              - sad
- hot under the collar                - turbulent
- feverish                            - hyperactive
- phobic                              - gun-shy
- provoked                            - unpeaceful
- disconsolate                        - wrecked
- stiff                               - grieved
- inconsolable                        - shook
- watchful                            - confused
- angstful                            - solicitous
- doubtful                            - disoriented
- hassled                             - inconvenienced
- irritated                           - gutted
- shot to pieces                      - overwhelmed
- basket case                         - beset
- riled                               - active
- sleepless                           - in a spin
- a wreck                             - erratic
- all of a flutter                    - muddled
- pained                              - harrowed
- beside yourself                     - in a flat spin
- wounded                             - in turmoil
- worried stiff                       - with one's stomach in knots
- tossing and turning                 - put out
- with your heart in your mouth       - angst-ridden
- twittering                          - mentally unsettled
- indecisive                          - tentative
- under pressure                      - dithering
- wavering                            - vacillating
- fussy                               - jerky
- swithering                          - mousy
- caught up                           - pressured
- frazzled                            - disorientated
- graceless                           - nerve-racking
- stressful                           - animated
- curt                                - roused
- easily frightened                   - easily agitated
- wreck                               - moving
- shot                                - exasperated
- withdrawn                           - faltering
- unnatural                           - gauche
- strict                              - conventional
- cautious                            - confined
- having cabin fever                  - restlessly moving
- Delphic                             - unassured
- unpoised                            - white knuckled
- bewildered                          - nerves on edge
- agog                                - eagerly
- stilted                             - prim
- blushing                            - retiring
- shrinking                           - stirred up
- flapping                            - palpitant
- wrung                               - peevish
- strange                             - lost
- peeved                              - dragged
- ripped                              - exercised
- critical                            - all agog
- avid                                - open-mouthed
- in a lather                         - flushed
- startled                            - intense
- hurried                             - transient
- wandering                           - intermittent
- changeable                          - inconstant
- footloose                           - roving
- nomadic                             - bustling
- recalcitrant                        - distrustful
- all nerves                          - on the qui vive
- old-fashioned                       - stir-crazy
- on the defensive                    - shaking in one's shoes
- aquiver                             - daunted
- refractory                          - unconsolable
- distrait                            - shot down
- with bated breath                   - anxiously waiting
- nervously awaiting                  - fearfully anticipating
- apprehensively expecting            - asea
- foreboding                          - mistrustful
- perverse                            - ornery
- obstinate                           - stubborn
- unyielding                          - aghast
- dreading                            - at fever pitch
- unreluctant                         - jiggly
- all wound up                        - exacerbated
- puzzled                             - displeased
- chagrined                           - aggravated
- mortified                           - pestered
- harried                             - frozen
- hyped-up                            - afire
- atingle                             - hyperexcited
- compulsive                          - manic
- obsessive                           - a basket case
- sweating bullets                    - lily-livered
- running scared                      - having stage fright
- biting nails                        - having cold feet
- having a funny feeling              - offended
- angered                             - disappointed
- fretted                             - champing at the bit
- wakeful                             - thrown
- low                                 - tooshie
- swivel-eyed                         - fixated
- oversensitive                       - temperamental
- insomniac                           - zipped up
- hot                                 - juiced up
- verklempt                           - blue
- unzipped                            - freaked-out
- wound-up                            - crazy
- high                                - keyed-up
- affected                            - fired-up
- hot-and-bothered                    - weary
- strung-out                          - worn
- unstrung                            - tired
- spent                               - unhealthy
- abnormal                            - paranoid
- miserable                           - come apart
- psyched out                         - broken up
- at sixes and sevens                 - in disorder
- amazed                              - throwing a wobbly
- awake                               - unsleeping
- maladjusted                         - steamed up
- flipped out                         - out of your mind
- impetuous                           - insomnolent
- hot under collar                    - all shook up
- aberrant                            - deviant
- disordered                          - obsessed
- hysteric                            - volatile
- alert                               - at the end of your tether
- dejected                            - despondent
- depressed                           - vigilant
- fiery                               - moody
- devastated                          - traumatized
- morose                              - heavyhearted
- broken                              - melancholy
- sorrowful                           - doleful
- bitter                              - heartbroken
- dolorous                            - desolate
- cheerless                           - without sleep
- wide awake                          - wide-awake
- attentive                           - eccentric
- grieving                            - despairing
- weeping                             - down
- bereaved                            - mournful
- heartsick                           - rueful
- hurting                             - mourning
- haunted                             - woeful
- crushed                             - agonized
- dolesome                            - hyperexcitable
- mercurial                           - passionate
- tempestuous                         - hyperkinetic
- sorrowing                           - woebegone
- in pain                             - heavy with grief
- bewailing                           - persecuted
- bemoaning                           - wailing
- agonised                            - racked with suffering
- broken-hearted                      - suffering
- aching                              - overcome with sorrow
- racked with pain                    - traumatised
- grief-stricken                      - brokenhearted
